.##############################
............#.....#.....#.....#
###########.#.#.###.#.###.#.###
#.#.......#.#.#.....#.#...#...#
#.#.#####.#.#.#####.#.#.#####.#
#.#.....#...#.#...#.#...#.#...#
#.#####.#####.#.#.###.###.#.#.#
#.....#.....#.#.#...#.....#.#.#
###.#.#####.#.#.###.#####.#.#.#
#...#.#.#...#.#...#.#.....#.#.#
#.###.#.#.#####.#.#.#######.#.#
#.#.....#.....#.#.#.#.......#.#
#.###########.###.#.#.#######.#
#...#...#...#.....#...#.......#
#.#.#.#.#.#.###########.#######
#.#...#...#...#.....#.#.......#
#.#########.#.#.###.#.#######.#
#.....#.....#...#.#...#.....#.#
#######.#########.###.#.###.#.#
#.......#.....#...#...#.#.#...#
#.#######.###.#.#.#.###.#.#####
#.#.....#...#.#.#.....#...#...#
#.#.#######.#.#.#########.#.#.#
#.#.........#...#.......#...#.#
#.#.#######.#####.#####.#####.#
#.#...#...#.#.....#.....#.....#
#.###.#.#.###.#####.###.#.#####
#.#...#.#...#.....#.#...#.#...#
#.#####.###.#####.#.#####.#.#.#
#.........#.......#.........#..
##############################.