.##############################
..#.#.....#.................#.#
#.#.#.###.#.#.#.#.#######.###.#
#...#.#...#.#.#.#...#...#.#...#
#.###.#.#.#.###.#.###.#.#.###.#
#...#.#.#.#...#.#.#...#.......#
#.#.###.#.#.###.#####.###.###.#
#.#.....#.#.#.....#...#...#.#.#
#.#####.#.#.#######.#.#####.###
#...#...#...#...#...#.....#...#
#.#.#####.###.#.#.#########.###
#.#.....#.#...#...#.#.......#.#
###############.#.#.#####.###.#
#...#.....#.....#.#...#.......#
#.#.###.###.###.###.###.#######
#.#...........#.#.#.....#.#...#
#####.#########.#.###.###.#.###
#.#.......#...........#.......#
#.###.#.#######.#.#.#.###.###.#
#.....#.#.#.....#.#.#...#.#...#
#######.#.#.#.#########.#####.#
#...#.#.#...#.#.....#.#.......#
#.#.#.#.#######.#.###.#####.###
#.#.............#.....#.......#
#####.#######.#.###.#.#########
#.#.....#...#.#...#.#.........#
#.#.###.#.#.###.###.#.###.#####
#.....#...#.#...#...#.#.#.....#
#######.#.#######.#.#.#.#####.#
#.......#...#.....#.#.....#....
##############################.